MMMMMMMMMMMMMMMMMMMMMMMM
M0000000000000000000000M
M00J0000000000000000000M
M0000000000000000000000M
M00000M0M0M0M0000MMM000M
M00000M0M0M0M0000M0M000M
M00000M0M0M0M0000M0M000M
M00000M0M0M0M000000M000M
M0000000000000000000000M
M0000000000000000000000M
MMMMMMMMMMMMMMMMMMMMMMMM
