MMMMMMMMMMMMMMMMMMMMMMMMMMMMMM
M0000000000000000000000MMMMMMM
M00J0000000000000000000MMMMMMM
M0000000000000000000000MMMMMMM
M00000M0M0M0M0000MMM000MMMMMMM
M00000M0M0M0M0000M0M000MMMMMMM
M00000M0M0M0M0000M0M000MMMMMMM
M00000M0M0M0M000000M000MMMMMMM
M0000000000000000000000MMMMMMM
M0000000000000000000000MMMMMMM
MMMMMMMMMMM00MMMMMMMMMMMMMMMMM
MMMMMMMMMMM00MMMMMMMMMMMMMMMMM
MMMMMMMMMMM00MMMMMMMMMMMMMMMMM
MMMMMMMMMMM00MMMMMMMMMMMMMMMMM
MMMMMMMMMMM00MMMMMMMMMMMMMMMMM
MMMMMMMMMMM00MMMMMMMMMMMMMMMMM
MMMMMMMMSSSSSSSSMMMMMMMMMMMMMM
MMMMMMMMSMMSSMMSMMMMMMMMMMMMMM
MMMMMMMMSMMSSMMSMMMMMMMMMMMMMM
MMMMMMMMSSSSSSSSMMMMMMMMMMMMMM
MMMMMMMMSSSMMSSSMMMMMMMMMMMMMM
MMMMMMMMSSMMMMSSMMMMMMMMMMMMMM
MMMMMMMMSSMSSMSSMMMMMMMMMMMMMM
MMMMMMMMSSSSSSSSMMMMMMMMMMMMMM
MMMMMMMMMMMMMMMMMMMMMMMMMMMMMM
MMMMMMMMMMMMMMMMMMMMMMMMMMMMMM
MMMMMMMMMMMMMMMMMMMMMMMMMMMMMM
MMMMMMMMMMMMMMMMMMMMMMMMMMMMMM
MMMMMMMMMMMMMMMMMMMMMMMMMMMMMM
MMMMMMMMMMMMMMMMMMMMMMMMMMMMMM
